111111111111111
1P0000000000001
101111111011111
1C0000001000001
101011101111101
1C00001000000C1
101110101011101
1C00000001000C1
111011111111101
1C000000E000001
101011111011101
1C00100000000C1
101111101111101
1C00010000000C1
111111111111111