11111111111111
1P000000000001
10111111111001
1C0010000100C1
10101110101001
1C000000E000C1
10111111111101
1C0001000000C1
11111111111111