11111111111111111111
1P000000000000000001
10111111101111111101
1C0000001000000000C1
10101110111110111001
1C0000100000100000C1
10111010101110111001
1C0000000100000000C1
10101111111110111001
1C0000000000E00000C1
10111010111110111001
1C0010000100000000C1
10111110111110111101
1C0000000000000000C1
10111111101111111101
1C0000001000000000C1
10101110111110111001
1C0001000000000000C1
11111111111111111111